1         
++++++++++
+        +
+   B    +
+        +
++++++   +
++++++   D
+ A+++   +
+        +
+        +
++++++++++
