1        2             
+++++++++++++++++++++++
+ v +    +      T     +
+   +        T  T   T +
+   +  + +   T      T w
+   +  + +   T  T   T +
+   +  + +   T  T   T +
+      + +      T     +
+   ++++ +   T  T   T +
+   ++++ +   T      T w
+++++++++++++++++++++++